T 0 0 0 0 0 0 0 A 0
0 X X X 0 0 X X X 0
0 X X X 0 0 X X X 0
0 X X X 0 0 X X X 0
0 0 0 0 0 T 0 0 0 0
H 0 0 0 0 0 0 0 0 0
0 X X X 0 0 X X X 0
0 X X X 0 0 X X X 0
0 X X X S 0 X X X 0
0 P 0 0 0 0 0 0 0 0