S 0 0 0 0 0 0 0 0 0
0 0 0 X 0 0 0 0 R 0
0 0 0 X 0 0 T 0 0 L
0 0 0 X 0 0 0 0 0 0
0 0 0 X X X X 0 0 0
0 0 0 0 0 0 X 0 H A
R 0 0 P 0 0 X 0 0 0
0 0 0 0 0 0 X 0 0 0
0 0 0 T 0 0 X 0 0 C
0 0 0 0 0 0 0 0 0 0